filename, language, C++, comment, blank, total
/home/mingrui/Mingrui/SLAMProject/ORB_SLAM2/src/Converter.cc, C++, 103, 19, 30, 152
/home/mingrui/Mingrui/SLAMProject/ORB_SLAM2/src/Frame.cc, C++, 486, 55, 142, 683
/home/mingrui/Mingrui/SLAMProject/ORB_SLAM2/src/FrameDrawer.cc, C++, 158, 22, 24, 204
/home/mingrui/Mingrui/SLAMProject/ORB_SLAM2/src/Initializer.cc, C++, 650, 72, 213, 935
/home/mingrui/Mingrui/SLAMProject/ORB_SLAM2/src/KeyFrame.cc, C++, 532, 33, 102, 667
/home/mingrui/Mingrui/SLAMProject/ORB_SLAM2/src/KeyFrameDatabase.cc, C++, 223, 37, 57, 317
/home/mingrui/Mingrui/SLAMProject/ORB_SLAM2/src/LocalMapping.cc, C++, 571, 72, 130, 773
/home/mingrui/Mingrui/SLAMProject/ORB_SLAM2/src/LoopClosing.cc, C++, 483, 196, 127, 806
/home/mingrui/Mingrui/SLAMProject/ORB_SLAM2/src/Map.cc, C++, 87, 23, 24, 134
/home/mingrui/Mingrui/SLAMProject/ORB_SLAM2/src/MapDrawer.cc, C++, 194, 22, 49, 265
/home/mingrui/Mingrui/SLAMProject/ORB_SLAM2/src/MapPoint.cc, C++, 327, 26, 69, 422
/home/mingrui/Mingrui/SLAMProject/ORB_SLAM2/src/ORBextractor.cc, C++, 901, 87, 158, 1146
/home/mingrui/Mingrui/SLAMProject/ORB_SLAM2/src/ORBmatcher.cc, C++, 1197, 104, 371, 1672
/home/mingrui/Mingrui/SLAMProject/ORB_SLAM2/src/Optimizer.cc, C++, 915, 69, 261, 1245
/home/mingrui/Mingrui/SLAMProject/ORB_SLAM2/src/PnPsolver.cc, C++, 772, 67, 184, 1023
/home/mingrui/Mingrui/SLAMProject/ORB_SLAM2/src/Sim3Solver.cc, C++, 280, 36, 111, 427
/home/mingrui/Mingrui/SLAMProject/ORB_SLAM2/src/System.cc, C++, 372, 64, 101, 537
/home/mingrui/Mingrui/SLAMProject/ORB_SLAM2/src/Tracking.cc, C++, 1170, 179, 290, 1639
/home/mingrui/Mingrui/SLAMProject/ORB_SLAM2/src/Viewer.cc, C++, 169, 23, 41, 233
Total, -, 9590, 1206, 2484, 13280